000000000000000000000
000000000000000000000
00#################00
00#################00
00#################00
00#################00
00########H########00
000000000000000000000


