000000000000000000000
00#0#0#0#0#0#0#0#0#00
000#0#0#0#0#0#0#0#000
00#0#0#0#0#0#0#0#0#00
000#0#0#0#0#0#0#0#000
00#0#0#0#0#0#0#0#0#00
000#0#0#0#0#0#0#0#000
000000000000000000000

